   _____                                 _   _             __      _____  
  / ____|                               | | (_)            \ \    / /__ \ 
 | |  __ _   _ _ __ ___  _ __   __ _ ___| |_ _  ___ ___  _ _\ \  / /   ) |
 | | |_ | | | | '_ ` _ \| '_ \ / _` / __| __| |/ __/ _ \| '_ \ \/ /   / / 
 | |__| | |_| | | | | | | | | | (_| \__ \ |_| | (_| (_) | | | \  /   / /_ 
  \_____|\__, |_| |_| |_|_| |_|\__,_|___/\__|_|\___\___/|_| |_|\/   |____|
          __/ |                                                           
         |___/                                                            